01000000000000000000
01011111111111111110
01011100000000000000
01011101111111111111
01011100000000000000
01011111111111111110
01011100000000000000
01011101111111111111
01011100000000000000
01011111111111111110
01011100000000000000
01011101111111111111
00011100000000000000
